0,0,0,0,0,0,0,0,0,0,0,0,0,0,0,0,0,0,0,0,0,0,0,0,0,0,0,0,0,0,0,0,0,0,0,0,0,0,0,0,0,0,0,0,0,0,0,0,0,0,0,0
0,5,5,5,5,5,5,5,5,5,5,3,3,3,3,3,3,3,3,3,3,2,2,2,2,2,2,2,2,2,2,3,3,3,3,3,3,3,3,3,3,5,5,5,5,5,5,5,5,5,5,0
0,5,5,5,5,5,5,5,5,5,5,3,3,3,3,3,3,3,3,3,3,2,2,2,2,2,2,2,2,2,2,3,3,3,3,3,3,3,3,3,3,5,5,5,5,5,5,5,5,5,5,0
0,5,5,405,5,5,5,5,5,5,5,3,3,3,3,3,3,3,3,3,3,2,2,2,2,2,2,2,2,2,2,3,3,3,3,3,3,3,3,3,3,5,5,5,5,5,5,5,205,5,5,0
0,5,5,5,5,5,5,5,5,5,5,3,3,3,3,3,3,3,3,3,3,2,2,2,2,2,2,2,2,2,2,3,3,3,3,3,3,3,3,3,3,5,5,5,5,5,5,5,5,5,5,0
0,5,5,5,5,2,2,2,2,2,2,2,2,2,2,2,2,2,2,2,2,2,2,2,2,2,2,2,2,2,2,2,2,2,2,2,2,2,2,2,2,2,2,2,2,2,2,5,5,5,5,0
0,5,5,5,5,2,2,2,2,2,2,2,2,2,2,2,2,2,2,2,2,2,2,2,2,2,2,2,2,2,2,2,2,2,2,2,2,2,2,2,2,2,2,2,2,2,2,5,5,5,5,0
0,5,5,5,5,2,2,2,2,2,2,2,3,3,3,3,3,2,2,2,3,3,3,3,3,2,2,2,2,2,3,2,2,2,2,3,3,3,3,3,2,2,2,2,2,2,2,5,5,5,5,0
0,5,5,5,5,2,2,2,2,2,2,2,3,2,2,2,2,2,2,2,3,2,2,2,3,2,2,2,2,2,3,2,2,2,2,2,2,2,2,3,2,2,2,2,2,2,2,5,5,5,5,0
0,5,5,5,5,2,2,2,2,2,2,2,3,2,2,2,2,2,2,2,3,2,2,2,3,2,2,2,2,2,3,2,2,2,2,2,2,2,2,3,2,2,2,2,2,2,2,5,5,5,5,0
0,5,5,5,5,2,2,2,2,2,2,2,3,3,3,3,3,2,2,2,3,2,2,2,3,2,2,2,2,2,3,2,2,2,2,3,3,3,3,3,2,2,2,2,2,2,2,5,5,5,5,0
0,5,5,5,5,2,2,2,2,2,2,2,2,2,2,2,3,2,2,2,3,2,2,2,3,2,2,2,2,2,3,2,2,2,2,3,2,2,2,3,2,2,2,2,2,2,2,3,3,3,3,0
0,3,3,3,3,2,2,2,2,2,2,2,2,2,2,2,3,2,2,2,3,2,2,2,3,2,2,2,2,2,3,2,2,2,2,3,2,2,2,3,2,2,2,2,2,2,2,3,3,3,3,0
0,3,3,3,3,2,2,2,2,2,2,2,3,3,3,3,3,2,2,2,3,3,3,3,3,2,2,2,2,3,3,2,2,2,2,3,3,3,3,3,2,2,2,2,2,2,2,3,3,3,3,0
0,3,3,3,3,2,2,2,2,2,2,2,2,2,2,2,2,2,2,2,2,2,2,2,2,2,2,2,2,2,2,2,2,2,2,2,2,2,2,2,2,2,2,2,2,2,2,3,3,3,3,0
0,3,3,3,3,2,2,2,2,2,2,2,2,2,2,2,2,2,2,2,2,2,2,2,2,2,2,2,2,2,2,2,2,2,2,2,2,2,2,2,2,2,2,2,2,2,2,3,3,3,3,0
0,3,3,3,3,1,1,13,13,13,13,1,1,1,1,1,1,1,1,1,1,13,13,13,13,13,13,13,13,13,13,13,2,2,2,2,2,2,13,13,13,13,13,13,13,13,13,13,13,3,3,0
0,3,3,3,3,1,1,13,13,13,13,1,1,1,1,1,1,1,1,1,13,13,13,13,13,13,13,13,13,13,13,13,13,2,2,2,2,13,13,13,13,13,13,13,13,13,13,13,13,13,3,0
0,3,3,3,3,1,1,13,13,13,13,1,1,1,1,1,1,1,1,1,13,13,13,13,13,13,13,13,13,13,13,13,13,2,2,2,2,13,13,13,13,13,13,13,13,13,13,13,13,13,3,0
0,3,3,3,3,1,1,13,13,13,13,1,1,1,1,1,1,1,1,1,13,13,13,1,1,1,1,1,1,1,13,13,13,2,2,2,2,13,13,13,2,2,2,2,2,2,2,13,13,13,3,0
0,3,3,3,3,1,1,13,13,13,13,1,1,1,1,1,1,1,1,1,13,13,13,1,1,1,1,1,1,1,13,13,13,2,2,2,2,13,13,13,2,2,2,2,2,2,2,13,13,13,3,0
0,3,3,3,3,1,1,13,13,13,13,1,1,1,1,1,1,1,1,1,13,13,13,1,1,1,1,1,1,1,13,13,13,2,2,2,2,2,2,2,2,2,2,2,2,2,2,13,13,13,2,0
0,1,1,1,1,1,1,13,13,13,13,1,1,1,1,1,1,1,1,1,13,13,13,1,1,1,1,1,1,1,13,13,13,2,2,2,2,2,2,2,2,2,2,2,2,2,2,13,13,13,2,0
0,1,1,1,1,1,1,13,13,13,13,1,1,1,1,1,1,1,1,1,13,13,13,1,1,1,1,1,1,1,13,13,13,2,2,2,2,2,2,2,2,2,2,2,2,2,2,13,13,13,2,0
0,1,1,1,1,1,1,13,13,13,13,1,1,1,1,1,1,1,1,1,13,13,13,1,1,1,1,13,13,13,13,13,13,2,2,2,2,2,2,2,2,2,2,2,2,2,2,13,13,13,2,0
0,1,1,1,1,1,1,13,13,13,13,1,1,1,1,1,1,1,1,1,13,13,13,1,1,1,1,13,13,13,13,13,13,2,2,2,2,2,13,13,13,13,13,13,13,13,13,13,13,13,2,0
0,1,1,1,1,1,1,13,13,13,13,1,1,1,1,1,1,1,1,1,13,13,13,2,2,2,2,13,13,13,13,13,2,2,2,2,2,13,13,13,13,13,13,13,13,13,13,13,13,2,2,0
0,1,1,1,1,1,1,13,13,13,13,1,1,1,1,1,1,1,1,1,13,13,13,2,2,2,2,2,2,2,2,2,2,2,2,2,2,13,13,13,2,2,2,2,2,2,2,2,2,2,2,0
0,1,1,1,1,1,1,13,13,13,13,1,1,1,1,1,1,1,1,1,13,13,13,2,2,2,2,2,2,2,2,2,2,2,2,2,2,13,13,13,2,2,2,2,2,2,2,2,2,2,2,0
0,1,1,1,1,1,1,13,13,13,13,1,1,1,1,1,1,1,1,1,13,13,13,2,2,2,2,2,2,2,2,2,2,2,2,2,2,13,13,13,2,2,2,2,2,2,2,2,2,2,2,0
0,3,3,3,3,1,1,13,13,13,13,1,1,1,1,1,1,1,1,1,13,13,13,2,2,2,2,2,2,2,2,2,2,2,2,2,2,13,13,13,2,2,2,2,2,2,2,2,2,2,2,0
0,3,3,3,3,1,1,13,13,13,13,1,1,1,1,1,1,1,1,1,13,13,13,2,2,2,2,2,2,2,13,13,13,2,2,2,2,13,13,13,2,2,2,2,2,2,2,13,13,13,3,0
0,3,13,13,13,13,13,13,13,13,13,13,13,13,13,13,1,1,1,1,13,13,13,2,2,2,2,2,2,2,13,13,13,2,2,2,2,13,13,13,2,2,2,2,2,2,2,13,13,13,3,0
0,3,13,13,13,13,13,13,13,13,13,13,13,13,13,13,1,1,1,1,13,13,13,13,13,13,13,13,13,13,13,13,13,2,2,2,2,13,13,13,13,13,13,13,13,13,13,13,13,13,3,0
0,3,13,13,13,13,13,13,13,13,13,13,13,13,13,13,1,1,1,1,13,13,13,13,13,13,13,13,13,13,13,13,13,2,2,2,2,13,13,13,13,13,13,13,13,13,13,13,13,13,3,0
0,3,13,13,13,13,13,13,13,13,13,13,13,13,13,13,1,1,1,1,1,13,13,13,13,13,13,13,13,13,13,13,2,2,2,2,2,2,13,13,13,13,13,13,13,13,13,13,13,3,3,0
0,3,3,3,3,1,1,1,1,1,1,1,1,1,1,1,1,1,1,1,1,1,1,1,1,1,1,1,1,1,1,1,1,1,1,1,1,1,1,1,1,1,1,1,1,1,1,3,3,3,3,0
0,3,3,3,3,1,1,1,1,1,1,1,1,1,1,1,1,1,1,1,1,1,1,1,1,1,1,1,1,1,1,1,1,1,1,1,1,1,1,1,1,1,1,1,1,1,1,3,3,3,3,0
0,3,3,3,3,1,1,1,1,1,1,1,1,1,1,1,1,1,1,1,1,1,1,1,1,1,1,1,1,1,1,1,1,1,1,1,1,1,1,1,1,1,1,1,1,1,1,3,3,3,3,0
0,3,3,3,3,1,1,1,1,1,1,1,1,1,1,1,1,1,1,1,1,1,1,1,1,1,1,1,1,1,1,1,1,1,1,1,1,1,1,1,1,1,1,1,1,1,1,3,3,3,3,0
0,5,5,5,5,1,1,1,3,3,3,3,1,1,1,1,3,1,1,3,1,1,1,1,3,1,1,3,1,1,1,1,3,3,3,3,1,1,1,1,3,1,1,3,1,1,1,3,3,3,3,0
0,5,5,5,5,1,1,1,3,1,1,1,1,1,1,1,3,1,1,3,1,1,1,1,3,1,3,3,1,1,1,1,3,1,1,3,1,1,1,1,3,1,3,3,1,1,1,5,5,5,5,0
0,5,5,5,5,1,1,1,3,1,1,1,1,1,1,1,3,3,3,3,1,1,1,1,3,3,1,3,1,1,1,1,3,1,1,3,1,1,1,1,3,3,3,3,1,1,1,5,5,5,5,0
0,5,5,5,5,1,1,1,3,1,1,1,1,1,1,1,3,1,1,3,1,1,1,1,3,3,1,3,1,1,1,1,3,1,1,3,1,1,1,1,3,3,1,3,1,1,1,5,5,5,5,0
0,5,5,5,5,1,1,1,3,3,3,3,1,1,1,1,3,3,3,3,1,1,1,1,3,1,1,3,1,1,1,1,3,3,3,3,1,1,1,1,3,1,1,3,1,1,1,5,5,5,5,0
0,5,5,5,5,1,1,1,1,1,1,1,1,1,1,1,1,1,1,1,1,1,1,1,1,1,1,1,1,1,1,1,1,1,1,1,1,1,1,1,1,1,1,1,1,1,1,5,5,5,5,0
0,5,5,5,5,1,1,1,1,1,1,1,1,1,1,1,1,1,1,1,1,1,1,1,1,1,1,1,1,1,1,1,1,1,1,1,1,1,1,1,1,1,1,1,1,1,1,5,5,5,5,0
0,5,5,5,5,5,5,5,5,5,5,5,3,3,3,3,3,3,3,3,3,3,1,1,1,1,1,1,1,1,3,3,3,3,3,3,3,3,3,3,5,5,5,5,5,5,5,5,5,5,5,0
0,5,5,105,5,5,5,5,5,5,5,5,3,3,3,3,3,3,3,3,3,3,1,1,1,1,1,1,1,1,3,3,3,3,3,3,3,3,3,3,5,5,5,5,5,5,5,5,305,5,5,0
0,5,5,5,5,5,5,5,5,5,5,5,3,3,3,3,3,3,3,3,3,3,1,1,1,1,1,1,1,1,3,3,3,3,3,3,3,3,3,3,5,5,5,5,5,5,5,5,5,5,5,0
0,5,5,5,5,5,5,5,5,5,5,5,3,3,3,3,3,3,3,3,3,3,1,1,1,1,1,1,1,1,3,3,3,3,3,3,3,3,3,3,5,5,5,5,5,5,5,5,5,5,5,0
0,0,0,0,0,0,0,0,0,0,0,0,0,0,0,0,0,0,0,0,0,0,0,0,0,0,0,0,0,0,0,0,0,0,0,0,0,0,0,0,0,0,0,0,0,0,0,0,0,0,0,0
