0,0,0,0,0,0,0,0,0,0,0,0,0,0,0,0,0,0,0,0,0,0,0,0,0,0,0,0,0,0,0,0,0,0,0,0,0,0,0,0,0,0,0,0,0,0,0,0,0,0,0,0
0,11,11,11,11,11,11,11,11,11,11,11,11,11,11,11,11,11,11,11,11,11,11,11,11,11,11,11,11,11,11,11,11,11,11,11,11,11,11,11,11,11,11,11,11,11,11,11,11,11,11,0
0,11,11,11,11,11,11,11,11,11,11,11,11,11,11,11,11,11,11,11,11,11,11,11,11,11,11,11,11,11,11,11,11,11,11,11,11,11,11,11,11,11,11,11,11,11,11,11,11,11,11,0
0,11,11,11,11,11,11,11,11,11,11,11,11,11,11,11,11,11,11,11,11,11,11,11,11,11,11,11,11,11,11,11,11,11,11,11,11,11,11,11,11,11,11,11,11,11,11,11,11,11,11,0
0,11,11,11,11,11,11,11,11,11,11,11,11,11,11,11,11,11,11,11,11,11,11,11,11,11,11,11,11,11,11,11,11,11,11,11,11,11,11,11,11,11,11,11,11,11,11,11,11,11,11,0
0,11,11,11,11,411,11,11,11,4,4,4,4,2,2,2,2,2,2,2,2,2,2,2,2,2,2,2,2,2,2,2,2,2,2,2,2,2,2,4,4,4,4,11,11,11,211,11,11,11,11,0
0,11,11,11,11,11,11,11,11,4,4,4,4,2,2,2,2,2,2,2,2,2,2,2,2,2,2,2,2,2,2,2,2,2,2,2,2,2,2,4,4,4,4,11,11,11,11,11,11,11,11,0
0,11,11,11,11,11,11,11,11,4,4,4,4,2,2,2,2,2,2,2,2,2,2,2,2,2,2,2,2,2,2,2,2,2,2,2,2,2,2,4,4,4,4,11,11,11,11,11,11,11,11,0
0,11,11,11,11,11,11,11,11,4,4,4,4,2,2,2,2,2,2,2,2,2,2,2,2,2,2,2,2,2,2,2,2,2,2,2,2,2,2,4,4,4,4,11,11,11,11,11,11,11,11,0
0,11,11,11,11,4,4,4,4,4,4,4,4,5,5,5,5,5,5,5,5,5,5,5,5,5,5,5,5,5,5,5,5,5,5,5,5,5,5,4,4,4,4,4,4,4,4,11,11,11,11,0
0,11,11,11,11,4,4,4,4,4,4,4,4,5,5,5,5,5,5,5,5,5,5,5,5,5,5,5,5,5,5,5,5,5,5,5,5,5,5,4,4,4,4,4,4,4,4,11,11,11,11,0
0,11,11,11,11,4,4,4,4,4,4,4,4,5,5,5,5,5,5,5,5,5,5,5,5,5,5,5,5,5,5,5,5,5,5,5,5,5,5,4,4,4,4,4,4,4,4,11,11,11,11,0
0,11,11,11,11,4,4,4,4,4,4,4,4,5,5,5,5,5,5,5,5,5,5,5,5,5,5,5,5,5,5,5,5,5,5,5,5,5,5,4,4,4,4,4,4,4,4,11,11,11,11,0
0,11,11,11,11,2,2,2,2,5,5,5,5,5,5,5,5,7,7,7,7,7,7,7,7,7,7,7,7,7,7,7,7,7,7,5,5,5,5,5,5,5,5,2,2,2,2,11,11,11,11,0
0,11,11,11,11,2,2,2,2,5,5,5,5,5,5,5,5,7,7,7,7,7,7,7,7,7,7,7,7,7,7,7,7,7,7,5,5,5,5,5,5,5,5,2,2,2,2,11,11,11,11,0
0,11,11,11,11,2,2,2,2,5,5,5,5,5,5,5,5,7,7,7,7,7,7,7,7,7,7,7,7,7,7,7,7,7,7,5,5,5,5,5,5,5,5,2,2,2,2,11,11,11,11,0
0,11,11,11,11,2,2,2,2,5,5,5,5,5,5,5,5,7,7,7,7,7,7,7,7,7,7,7,7,7,7,7,7,7,7,5,5,5,5,5,5,5,5,2,2,2,2,11,11,11,11,0
0,11,11,11,11,2,2,2,2,5,5,5,5,7,7,7,7,7,7,7,6,6,6,6,6,6,6,6,6,6,6,6,7,7,7,7,7,7,7,5,5,5,5,2,2,2,2,11,11,11,11,0
0,11,11,11,11,2,2,2,2,5,5,5,5,7,7,7,7,7,7,7,6,6,6,6,6,6,6,6,6,6,6,6,7,7,7,7,7,7,7,5,5,5,5,2,2,2,2,11,11,11,11,0
0,11,11,11,11,2,2,2,2,5,5,5,5,7,7,7,7,7,7,7,6,6,6,6,6,6,6,6,6,6,6,6,7,7,7,7,7,7,7,5,5,5,5,2,2,2,2,11,11,11,11,0
0,11,11,11,11,2,2,2,2,5,5,5,5,7,7,7,7,6,6,6,6,6,6,6,6,6,6,6,6,6,6,6,6,6,6,7,7,7,7,5,5,5,5,2,2,2,2,11,11,11,11,0
0,11,11,11,11,2,2,2,2,5,5,5,5,7,7,7,7,6,6,6,6,6,6,0,0,0,0,0,0,6,6,6,6,6,6,7,7,7,7,5,5,5,5,2,2,2,2,11,11,11,11,0
0,11,11,11,11,2,2,2,2,5,5,5,5,7,7,7,7,6,6,6,6,6,6,0,0,0,0,0,0,6,6,6,6,6,6,7,7,7,7,5,5,5,5,2,2,2,2,11,11,11,11,0
0,11,11,11,11,2,2,2,2,5,5,5,5,7,7,7,7,6,6,6,6,0,0,0,0,0,0,0,0,0,0,6,6,6,6,7,7,7,7,5,5,5,5,2,2,2,2,11,11,11,11,0
0,11,11,11,11,2,2,2,2,5,5,5,5,7,7,7,7,6,6,6,6,0,0,0,0,0,0,0,0,0,0,6,6,6,6,7,7,7,7,5,5,5,5,2,2,2,2,11,11,11,11,0
0,11,11,11,11,2,2,2,2,5,5,5,5,7,7,7,7,6,6,6,6,0,0,0,0,0,0,0,0,0,0,6,6,6,6,7,7,7,7,5,5,5,5,2,2,2,2,11,11,11,11,0
0,11,11,11,11,2,2,2,2,5,5,5,5,7,7,7,7,6,6,6,6,0,0,0,0,0,0,0,0,0,0,6,6,6,6,7,7,7,7,5,5,5,5,2,2,2,2,11,11,11,11,0
0,11,11,11,11,2,2,2,2,5,5,5,5,7,7,7,7,6,6,6,6,0,0,0,0,0,0,0,0,0,0,6,6,6,6,7,7,7,7,5,5,5,5,2,2,2,2,11,11,11,11,0
0,11,11,11,11,2,2,2,2,5,5,5,5,7,7,7,7,6,6,6,6,0,0,0,0,0,0,0,0,0,0,6,6,6,6,7,7,7,7,5,5,5,5,2,2,2,2,11,11,11,11,0
0,11,11,11,11,2,2,2,2,5,5,5,5,7,7,7,7,6,6,6,6,6,6,0,0,0,0,0,0,6,6,6,6,6,6,7,7,7,7,5,5,5,5,2,2,2,2,11,11,11,11,0
0,11,11,11,11,2,2,2,2,5,5,5,5,7,7,7,7,6,6,6,6,6,6,0,0,0,0,0,0,6,6,6,6,6,6,7,7,7,7,5,5,5,5,2,2,2,2,11,11,11,11,0
0,11,11,11,11,2,2,2,2,5,5,5,5,7,7,7,7,6,6,6,6,6,6,6,6,6,6,6,6,6,6,6,6,6,6,7,7,7,7,5,5,5,5,2,2,2,2,11,11,11,11,0
0,11,11,11,11,2,2,2,2,5,5,5,5,7,7,7,7,7,7,7,6,6,6,6,6,6,6,6,6,6,6,6,7,7,7,7,7,7,7,5,5,5,5,2,2,2,2,11,11,11,11,0
0,11,11,11,11,2,2,2,2,5,5,5,5,7,7,7,7,7,7,7,6,6,6,6,6,6,6,6,6,6,6,6,7,7,7,7,7,7,7,5,5,5,5,2,2,2,2,11,11,11,11,0
0,11,11,11,11,2,2,2,2,5,5,5,5,7,7,7,7,7,7,7,6,6,6,6,6,6,6,6,6,6,6,6,7,7,7,7,7,7,7,5,5,5,5,2,2,2,2,11,11,11,11,0
0,11,11,11,11,2,2,2,2,5,5,5,5,5,5,5,5,7,7,7,7,7,7,7,7,7,7,7,7,7,7,7,7,7,7,5,5,5,5,5,5,5,5,2,2,2,2,11,11,11,11,0
0,11,11,11,11,2,2,2,2,5,5,5,5,5,5,5,5,7,7,7,7,7,7,7,7,7,7,7,7,7,7,7,7,7,7,5,5,5,5,5,5,5,5,2,2,2,2,11,11,11,11,0
0,11,11,11,11,2,2,2,2,5,5,5,5,5,5,5,5,7,7,7,7,7,7,7,7,7,7,7,7,7,7,7,7,7,7,5,5,5,5,5,5,5,5,2,2,2,2,11,11,11,11,0
0,11,11,11,11,2,2,2,2,5,5,5,5,5,5,5,5,7,7,7,7,7,7,7,7,7,7,7,7,7,7,7,7,7,7,5,5,5,5,5,5,5,5,2,2,2,2,11,11,11,11,0
0,11,11,11,11,4,4,4,4,4,4,4,4,5,5,5,5,5,5,5,5,5,5,5,5,5,5,5,5,5,5,5,5,5,5,5,5,5,5,4,4,4,4,4,4,4,4,11,11,11,11,0
0,11,11,11,11,4,4,4,4,4,4,4,4,5,5,5,5,5,5,5,5,5,5,5,5,5,5,5,5,5,5,5,5,5,5,5,5,5,5,4,4,4,4,4,4,4,4,11,11,11,11,0
0,11,11,11,11,4,4,4,4,4,4,4,4,5,5,5,5,5,5,5,5,5,5,5,5,5,5,5,5,5,5,5,5,5,5,5,5,5,5,4,4,4,4,4,4,4,4,11,11,11,11,0
0,11,11,11,11,4,4,4,4,4,4,4,4,5,5,5,5,5,5,5,5,5,5,5,5,5,5,5,5,5,5,5,5,5,5,5,5,5,5,4,4,4,4,4,4,4,4,11,11,11,11,0
0,11,11,11,11,11,11,11,11,4,4,4,4,2,2,2,2,2,2,2,2,2,2,2,2,2,2,2,2,2,2,2,2,2,2,2,2,2,2,4,4,4,4,11,11,11,11,11,11,11,11,0
0,11,11,11,11,11,11,11,11,4,4,4,4,2,2,2,2,2,2,2,2,2,2,2,2,2,2,2,2,2,2,2,2,2,2,2,2,2,2,4,4,4,4,11,11,11,11,11,11,11,11,0
0,11,11,11,11,11,11,11,11,4,4,4,4,2,2,2,2,2,2,2,2,2,2,2,2,2,2,2,2,2,2,2,2,2,2,2,2,2,2,4,4,4,4,11,11,11,11,11,11,11,11,0
0,11,11,11,11,111,11,11,11,4,4,4,4,2,2,2,2,2,2,2,2,2,2,2,2,2,2,2,2,2,2,2,2,2,2,2,2,2,2,4,4,4,4,11,11,11,311,11,11,11,11,0
0,11,11,11,11,11,11,11,11,11,11,11,11,11,11,11,11,11,11,11,11,11,11,11,11,11,11,11,11,11,11,11,11,11,11,11,11,11,11,11,11,11,11,11,11,11,11,11,11,11,11,0
0,11,11,11,11,11,11,11,11,11,11,11,11,11,11,11,11,11,11,11,11,11,11,11,11,11,11,11,11,11,11,11,11,11,11,11,11,11,11,11,11,11,11,11,11,11,11,11,11,11,11,0
0,11,11,11,11,11,11,11,11,11,11,11,11,11,11,11,11,11,11,11,11,11,11,11,11,11,11,11,11,11,11,11,11,11,11,11,11,11,11,11,11,11,11,11,11,11,11,11,11,11,11,0
0,11,11,11,11,11,11,11,11,11,11,11,11,11,11,11,11,11,11,11,11,11,11,11,11,11,11,11,11,11,11,11,11,11,11,11,11,11,11,11,11,11,11,11,11,11,11,11,11,11,11,0
0,0,0,0,0,0,0,0,0,0,0,0,0,0,0,0,0,0,0,0,0,0,0,0,0,0,0,0,0,0,0,0,0,0,0,0,0,0,0,0,0,0,0,0,0,0,0,0,0,0,0,0
