0,0,0,0,0,0,0,0,0,0,0,0,0,0,0,0,0,0,0,0,0,0,0,0,0,0,0,0,0,0,0,0,0,0,0,0,0,0,0,0,0,0,0,0,0,0,0,0,0,0,0,0
0,4,4,4,4,4,4,4,4,4,4,4,4,4,4,4,4,4,4,4,4,4,4,4,4,4,4,4,4,4,4,4,4,4,4,4,4,4,4,4,4,4,4,4,4,4,4,4,4,4,4,0
0,4,4,4,4,4,4,4,4,4,4,4,4,4,4,4,4,4,4,4,4,4,4,4,4,4,4,4,4,4,4,4,4,4,4,4,4,4,4,4,4,4,4,4,4,4,4,4,4,4,4,0
0,4,4,3,3,3,3,11,11,11,11,11,11,4,4,11,11,11,11,11,11,11,11,11,11,4,4,11,11,11,11,11,11,11,11,11,11,4,4,11,11,11,11,11,11,3,3,3,3,4,4,0
0,4,4,3,3,3,3,11,11,11,11,11,11,4,4,11,11,11,11,11,11,11,11,11,11,4,4,11,11,11,11,11,11,11,11,11,11,4,4,11,11,11,11,11,11,3,3,3,3,4,4,0
0,4,4,3,3,2,2,11,11,11,11,11,11,4,4,11,11,11,11,11,11,11,11,11,11,4,4,11,11,11,11,11,11,11,11,11,11,4,4,11,11,11,11,11,11,2,2,3,3,4,4,0
0,4,4,3,3,2,2,11,11,11,11,11,11,4,4,11,11,11,11,11,11,11,11,11,11,4,4,11,11,11,11,11,11,11,11,11,11,4,4,11,11,11,11,11,11,2,2,3,3,4,4,0
0,4,4,11,11,11,11,11,11,11,11,11,11,4,4,11,11,11,11,11,11,11,11,11,11,4,4,11,11,11,11,11,11,11,11,11,11,4,4,11,11,11,11,11,11,11,11,11,11,4,4,0
0,4,4,11,11,11,11,11,311,11,11,11,11,4,4,11,11,11,11,11,11,11,11,11,11,4,4,11,11,11,11,11,11,11,11,11,11,4,4,11,11,11,11,411,11,11,11,11,11,4,4,0
0,4,4,11,11,11,11,11,11,11,11,11,11,4,4,11,11,11,11,11,11,11,11,11,11,4,4,11,11,11,11,11,11,11,11,11,11,4,4,11,11,11,11,11,11,11,11,11,11,4,4,0
0,4,4,11,11,11,11,11,11,11,11,11,11,4,4,11,11,11,11,11,11,11,11,11,11,4,4,11,11,11,11,11,11,11,11,11,11,4,4,11,11,11,11,11,11,11,11,11,11,4,4,0
0,4,4,11,11,11,11,11,11,11,11,11,11,4,4,11,11,11,11,11,11,11,11,11,11,4,4,11,11,11,11,11,11,11,11,11,11,4,4,11,11,11,11,11,11,11,11,11,11,4,4,0
0,4,4,11,11,11,11,11,11,11,11,11,11,4,4,11,11,11,11,11,11,11,11,11,11,4,4,11,11,11,11,11,11,11,11,11,11,4,4,11,11,11,11,11,11,11,11,11,11,4,4,0
0,4,4,4,4,4,4,4,4,4,4,4,4,4,4,4,4,4,4,4,4,4,4,4,4,4,4,4,4,4,4,4,4,4,4,4,4,4,4,4,4,4,4,4,4,4,4,4,4,4,4,0
0,4,4,4,4,4,4,4,4,4,4,4,4,4,4,4,4,4,4,4,4,4,4,4,4,4,4,4,4,4,4,4,4,4,4,4,4,4,4,4,4,4,4,4,4,4,4,4,4,4,4,0
0,4,4,11,11,11,11,11,11,11,11,11,11,4,4,11,11,11,11,11,11,11,11,11,11,4,4,11,11,11,11,11,11,11,11,11,11,4,4,11,11,11,11,11,11,11,11,11,11,4,4,0
0,4,4,11,11,11,11,11,11,11,11,11,11,4,4,11,11,11,11,11,11,11,11,11,11,4,4,11,11,11,11,11,11,11,11,11,11,4,4,11,11,11,11,11,11,11,11,11,11,4,4,0
0,4,4,11,11,11,11,11,11,11,11,11,11,4,4,11,11,11,11,11,11,11,11,11,11,4,4,11,11,11,11,11,11,11,11,11,11,4,4,11,11,11,11,11,11,11,11,11,11,4,4,0
0,4,4,11,11,11,11,11,11,11,11,11,11,4,4,11,11,11,11,11,11,11,11,11,11,4,4,11,11,11,11,11,11,11,11,11,11,4,4,11,11,11,11,11,11,11,11,11,11,4,4,0
0,4,4,11,11,11,11,11,11,11,11,11,11,4,4,11,11,11,11,11,11,11,11,11,5,5,5,5,11,11,11,11,11,11,11,11,11,4,4,11,11,11,11,11,11,11,11,11,11,4,4,0
0,4,4,11,11,11,11,11,11,11,11,11,11,4,4,11,11,11,11,11,11,11,11,5,5,5,5,5,5,11,11,11,11,11,11,11,11,4,4,11,11,11,11,11,11,11,11,11,11,4,4,0
0,4,4,11,11,11,11,11,11,11,11,11,11,4,4,11,11,11,11,11,11,11,5,5,5,6,6,5,5,5,11,11,11,11,11,11,11,4,4,11,11,11,11,11,11,11,11,11,11,4,4,0
0,4,4,11,11,11,11,11,11,11,11,11,11,4,4,11,11,11,11,11,11,5,5,5,6,6,6,6,5,5,5,11,11,11,11,11,11,4,4,11,11,11,11,11,11,11,11,11,11,4,4,0
0,4,4,11,11,11,11,11,11,11,11,11,11,4,4,11,11,11,11,11,5,5,5,6,6,7,7,6,6,5,5,5,11,11,11,11,11,4,4,11,11,11,11,11,11,11,11,11,11,4,4,0
0,4,4,11,11,11,11,11,11,11,11,11,11,4,4,11,11,11,11,5,5,5,6,6,7,7,7,7,6,6,5,5,5,11,11,11,11,4,4,11,11,11,11,11,11,11,11,11,11,4,4,0
0,4,4,4,4,4,4,4,4,4,4,4,4,4,4,4,4,4,4,5,5,6,6,7,7,7,7,7,7,6,6,5,5,4,4,4,4,4,4,4,4,4,4,4,4,4,4,4,4,4,4,0
0,4,4,4,4,4,4,4,4,4,4,4,4,4,4,4,4,4,4,5,5,6,6,7,7,7,7,7,7,6,6,5,5,4,4,4,4,4,4,4,4,4,4,4,4,4,4,4,4,4,4,0
0,4,4,11,11,11,11,11,11,11,11,11,11,4,4,11,11,11,11,5,5,5,6,6,7,7,7,7,6,6,5,5,5,11,11,11,11,4,4,11,11,11,11,11,11,11,11,11,11,4,4,0
0,4,4,11,11,11,11,11,11,11,11,11,11,4,4,11,11,11,11,11,5,5,5,6,6,7,7,6,6,5,5,5,11,11,11,11,11,4,4,11,11,11,11,11,11,11,11,11,11,4,4,0
0,4,4,11,11,11,11,11,11,11,11,11,11,4,4,11,11,11,11,11,11,5,5,5,6,6,6,6,5,5,5,11,11,11,11,11,11,4,4,11,11,11,11,11,11,11,11,11,11,4,4,0
0,4,4,11,11,11,11,11,11,11,11,11,11,4,4,11,11,11,11,11,11,11,5,5,5,6,6,5,5,5,11,11,11,11,11,11,11,4,4,11,11,11,11,11,11,11,11,11,11,4,4,0
0,4,4,11,11,11,11,11,11,11,11,11,11,4,4,11,11,11,11,11,11,11,11,5,5,5,5,5,5,11,11,11,11,11,11,11,11,4,4,11,11,11,11,11,11,11,11,11,11,4,4,0
0,4,4,11,11,11,11,11,11,11,11,11,11,4,4,11,11,11,11,11,11,11,11,11,5,5,5,5,11,11,11,11,11,11,11,11,11,4,4,11,11,11,11,11,11,11,11,11,11,4,4,0
0,4,4,11,11,11,11,11,11,11,11,11,11,4,4,11,11,11,11,11,11,11,11,11,11,4,4,11,11,11,11,11,11,11,11,11,11,4,4,11,11,11,11,11,11,11,11,11,11,4,4,0
0,4,4,11,11,11,11,11,11,11,11,11,11,4,4,11,11,11,11,11,11,11,11,11,11,4,4,11,11,11,11,11,11,11,11,11,11,4,4,11,11,11,11,11,11,11,11,11,11,4,4,0
0,4,4,11,11,11,11,11,11,11,11,11,11,4,4,11,11,11,11,11,11,11,11,11,11,4,4,11,11,11,11,11,11,11,11,11,11,4,4,11,11,11,11,11,11,11,11,11,11,4,4,0
0,4,4,11,11,11,11,11,11,11,11,11,11,4,4,11,11,11,11,11,11,11,11,11,11,4,4,11,11,11,11,11,11,11,11,11,11,4,4,11,11,11,11,11,11,11,11,11,11,4,4,0
0,4,4,4,4,4,4,4,4,4,4,4,4,4,4,4,4,4,4,4,4,4,4,4,4,4,4,4,4,4,4,4,4,4,4,4,4,4,4,4,4,4,4,4,4,4,4,4,4,4,4,0
0,4,4,4,4,4,4,4,4,4,4,4,4,4,4,4,4,4,4,4,4,4,4,4,4,4,4,4,4,4,4,4,4,4,4,4,4,4,4,4,4,4,4,4,4,4,4,4,4,4,4,0
0,4,4,11,11,11,11,11,11,11,11,11,11,4,4,11,11,11,11,11,11,11,11,11,11,4,4,11,11,11,11,11,11,11,11,11,11,4,4,11,11,11,11,11,11,11,11,11,11,4,4,0
0,4,4,11,11,11,11,11,11,11,11,11,11,4,4,11,11,11,11,11,11,11,11,11,11,4,4,11,11,11,11,11,11,11,11,11,11,4,4,11,11,11,11,11,11,11,11,11,11,4,4,0
0,4,4,11,11,11,11,11,11,11,11,11,11,4,4,11,11,11,11,11,11,11,11,11,11,4,4,11,11,11,11,11,11,11,11,11,11,4,4,11,11,11,11,11,11,11,11,11,11,4,4,0
0,4,4,11,11,11,11,11,11,11,11,11,11,4,4,11,11,11,11,11,11,11,11,11,11,4,4,11,11,11,11,11,11,11,11,11,11,4,4,11,11,11,11,11,11,11,11,11,11,4,4,0
0,4,4,11,11,11,11,11,111,11,11,11,11,4,4,11,11,11,11,11,11,11,11,11,11,4,4,11,11,11,11,11,11,11,11,11,11,4,4,11,11,11,11,211,11,11,11,11,11,4,4,0
0,4,4,11,11,11,11,11,11,11,11,11,11,4,4,11,11,11,11,11,11,11,11,11,11,4,4,11,11,11,11,11,11,11,11,11,11,4,4,11,11,11,11,11,11,11,11,11,11,4,4,0
0,4,4,3,3,2,2,11,11,11,11,11,11,4,4,11,11,11,11,11,11,11,11,11,11,4,4,11,11,11,11,11,11,11,11,11,11,4,4,11,11,11,11,11,11,2,2,3,3,4,4,0
0,4,4,3,3,2,2,11,11,11,11,11,11,4,4,11,11,11,11,11,11,11,11,11,11,4,4,11,11,11,11,11,11,11,11,11,11,4,4,11,11,11,11,11,11,2,2,3,3,4,4,0
0,4,4,3,3,3,3,11,11,11,11,11,11,4,4,11,11,11,11,11,11,11,11,11,11,4,4,11,11,11,11,11,11,11,11,11,11,4,4,11,11,11,11,11,11,3,3,3,3,4,4,0
0,4,4,3,3,3,3,11,11,11,11,11,11,4,4,11,11,11,11,11,11,11,11,11,11,4,4,11,11,11,11,11,11,11,11,11,11,4,4,11,11,11,11,11,11,3,3,3,3,4,4,0
0,4,4,4,4,4,4,4,4,4,4,4,4,4,4,4,4,4,4,4,4,4,4,4,4,4,4,4,4,4,4,4,4,4,4,4,4,4,4,4,4,4,4,4,4,4,4,4,4,4,4,0
0,4,4,4,4,4,4,4,4,4,4,4,4,4,4,4,4,4,4,4,4,4,4,4,4,4,4,4,4,4,4,4,4,4,4,4,4,4,4,4,4,4,4,4,4,4,4,4,4,4,4,0
0,0,0,0,0,0,0,0,0,0,0,0,0,0,0,0,0,0,0,0,0,0,0,0,0,0,0,0,0,0,0,0,0,0,0,0,0,0,0,0,0,0,0,0,0,0,0,0,0,0,0,0
